C 80,100,80                               
NO ./assets/dungeon_walls/NO.xpm
SO ./assets/dungeon_walls/SO.xpm
EA   ./assets/dungeon_walls/WE.xpm
WE   ./assets/dungeon_walls/EA.xpm
       F    234,182,118          
       
       

       
       


        1111111111111111111111111
        1000000000110000000000001
        1011000001110000000000001 
        1001000000000000000000001
111111111011000001110000000000001
1000000000110000001110111111011111
11110111111111011100000010001
1111011110000011110101010001
1100000010000001110000001001
10000000000000011001000000101
10000000000000111100110010001
1100000111101111111101111000111
11110111 100011 1011110100W01
11111111 111111  111111111111
11111111111111111111111111111
10101010101010101010101010101
11111111111111111111111111111
