C 0,0,255                               
NO ./assets/dungeon_walls/SO.xpm
SO ./assets/dungeon_walls/SO.xpm
EA   ./assets/dungeon_walls/EA.xpm
WE   ./assets/MIRROR.xpm
       F    234,0,98          
       
       

       
       


1111111111111111111111111
1000000000001000000000001
1000000000001000000000001
1001100000000000001100001
1001100000001000001100001
1000000000000000000000001
1000000000001000000000001
1001100000000000001100001
1001100000001000001100001
1000000000000000000000001
1000000000001000000000001
1110111110011100111110111
1000001000000000001000001
100000100000N000001000001
1111111111111111111111111
