C 60,0,80                               
NO ./assets/walls/NO.xpm
SO ./assets/walls/SO.xpm
EA   ./assets/walls/EA.xpm
       F    54,69,88
       
       
              
       
       
WE ./assets/walls/WE.xpm

        1111111111111111111111111
        1000000000110000000000001
        1011000001110000000000001
        1001000000000000000000001
111111111011000001110000W00000001
1000000000110000001110111111011111
11110111111111011100000010001
1111011111111101110101010001
1100000011010111110000001001
10000000000001  1001000000101
10000000000001111100110010001
1100000111010101111101111000111
11110111 1110101 101111010001
11111111 1111111 111111111111
11111111111111111111111111111
10101010101010101010101010101
11111111111111111111111111111111111111111111111111111111111111111111111111111111111111111111111111111111111111111111111111
