C 80,100,80
NO ./assets/dungeon_walls/NO.xpm
SO ./assets/dungeon_walls/SO.xpm
EA ./assets/dungeon_walls/EA.xpm
WE ./assets/dungeon_walls/WE.xpm
F 234,182,118

111111111111111111111111111111
1000000000110000000111111110001
1000000000110000000100000110001
100011100011110111100000000001
100010100010000001100000010001
10001011111000000111111111001
10001000001000000000010000001
10001101111000000000000000001
10000000010000000000010000001
10010000000000000000110000001
10010000000000000000110000001
10010000010000000000110000001
10010000010000000000110000001
100111111111110111111111100111
100000000000000000000000000001
111100111000100010001110011111
100000001000000000001000000001
100000000000000000000000000001
111111111111110111111111111111
           1000001
           100N001
           1000001
           1111111
