C 80,100,80
NO ./assets/dungeon_walls/NO.xpm
SO ./assets/dungeon_walls/SO.xpm
EA ./assets/dungeon_walls/EA.xpm
WE ./assets/dungeon_walls/protect.xpm
F 234,182,118

111111111111111111111111111111111
101010101010101010101010101010101
1111111111111111111101010101010101
            100000101010101010101
            1000001101010101010101111111111111111111111111111111111111111111111111111111111
            100N000000000000000000000000000000000000000000000000000000000000000000000000001
            1000000000000000000000000000000000000000000000000000000000000000000000000000001
            1000000000000000000000000000000000000000000000000000000000000000000000000000001
            1111111111111111111111111111111111111111111111111111111111111111111111111111111
