C 80,100,80
NO ./assets/dungeon_walls/NO.xpm
SO ./assets/dungeon_walls/SO.xpm
EA ./assets/dungeon_walls/EA.xpm
WE ./assets/dungeon_walls/protect.xpm
F 234,182,118

11111
10001
10N01
10001
11111
